####################
#1  # # # # # # # 3#
##                 #
#                  #
##                 #
#    3#######2     #
##                 #
#    3###1         #
##                 #
#                  #
##        4###1    #
#                  #
##                 #
#2                4#
####################